00000000000000000
11111111111111111
13131313131313131
11111111111111111
22000000200000022
00003310001330000
00000000000000000
00000000000000000
00000000000000000
00000000000000000