00000000000000000
01010101010101010
00102020202020100
01010202020201010
00102020202020100
01010101010101000
00000000000000000
00000000000000000
00000000000000000
00000000000000000